20 30
##############################
#                            #
#    w               <       #
#####                        #
#            @@@             #
#    o        #####          #
#                         ####
#             @@@    «       #
#                            #
#                            #
#               H            #
#    ^                       #
#                            #
#####        <    #          #
#   <#           #         @@#
## ######### ##            @@#
#  #          #           @@@#
#  ### ###### #          @@@@#
#      #      #          @@mm#
##############################